100 100


##################
##......S1......##
##..............##
##..............##
##..............##
##mmmmll..llmmmm##
      mm..mm
      mm..mm
      mm..mm
      mm..mm
########..########
##..............##
##..............##
##..............##
##......FF......##
##mmmmmmmmmmmmmm##


