100 100

  #########
  #...1...#
  #.......#
  #.......#
  #.......#
  #mmm.mmm#
     m.m
     m.m
     m.m
     m.m
     m.m
     m.m
     m.m
######2#######
#SSSS....SSSS#
#SSSS.Br.SSSS#
#S..SSB..SSSS#
#S.SSSSSSSSSS#
#S.SSSSSSSSSS#
#S.SSSSSSSSSS#
#S.....BSSB.S#
#SSSSS.SSSSSS#
#mmmmm.mmmmmm#
     m.m
     m.m
     m.m
     m.m
     m.m
  ####.####
  #.......#
  #.......#
  #.......#
  #...E...#
  #mmmmmmm#