100 100


        #########
        #...1...#
        #.......#
        #.......#
        #.......#
        #mmm.mmm#
           m.m
           m.m
           m.m
           m.m
        ####.####
        #.......#
        #.......#
        #.......#
        #...F...#
        #mmmmmmm#

