100 100

 #########
 #...1...#
 #.......#
 #.......#
 #.SSSSSS#
 #.......#
 #SSSSSS.#
 #.......#
 #.B.SSSS#
 #SSSmmmm#
 #.......#  ############
 #mmm.mmm#  #....L.....#
    m.m     #..L.L.S..<#
    m.m     #..L.L.S...#
    m.#######..L.L.S..<#
    m........2.L.L.S...#
    mmmmmmmmmmmL.L.S...#
            m.>L.L.S...#
            m....L.S...#
            m.>..L.S...########
            m.B....S..........#
            mmmmmmmmmmmmmmmmm.#
                            m.#
                            m.#
                            m.#
                            m.#
                       ######.######
                       #.....3.....#
                       #.B.B...B.B.#
                       #...........#
                       #LLLSSSSSLLL#
                       #...A...A...#
                       #...........#
                       #...........#
                       #mmmmm.mmmmm#
                            m.m
                            m.m
                            m.m
                            m.m
                            m.m
                       ######.######
                       #.....4.....#
                       #.B.B...B.B.#
                       #...........#
                       #LLLLLSLLLLL#
                       #...A...A...#
                       #...........#
                       #.....F.....#
                       #mmmmmmmmmmm#